NFkB1-1	 NNNGACTTTCCRNNN
Sp1-1	 GGGACGTGGYBA
Ap1	 GNNTKMMWSANNG
USF	 DCCATNRWCACVKRGC
LSF-YY1	 NNGNDCCATNGNN
LEF1	 WYTACAARRACTGCA
RBF2	 NGNACTGMTRACNGN
C/EBP	 NGCAYKDMRWCAYVKN
E2F-1	 NGTTTCCRCTWRGN 
p53	 NGGYGTGGYYTN
CoreNRE	 CAYKDMRWCACVTRGC
COUP	 GGRCCAGGGRYYAGATWYCCACTGWSHTTTGGRT
NFAT	 RRDGARGTGARRARGMCGGGMAATCRAAGGAGARA
CBF	 NGNTGGGAANGN
Spacer	 NATGCGTAGGCN
NMF-1	 SMSGAMAGAGAAGTGTT   
NMF-2	 RRWRTGGAAGTTGACACC 
NMF3	 YMGCTAGCAYKHMRWCACAVTGGCCC
EBS	 MWRCATCCGGAGT 
Ebox	 ACVTRGCYMRMG
RCS	 RTYTGAGCCYGGGAGCTCTCTGG
NFkB1-2	 GGMCKTTCCRG
Sp1-2	 NTGGGCGGGACN
Sp1-3	 NRGGYGHGGYTTN
Ebox2	 NGNNCANNTGNGNN
EcoR1	 GAATTC